XXXXXXXXXXXXXXXXXXXXXXXXXXXX
X         XX    XX         X
X XXXX XX XX XX XX XX XXXX X
X XXXX XX XX XX XX XX XXXX X
X      XX    XX    XX      X
X XXXX XXXXX XX XXXXX XXXX X
X XXXX XXXXX XX XXXXX XXXX X
X XX         XX         XX X
X XX XXXX XXXXXXXX XXXX XX X
X XX XXXX XXXXXXXX XXXX XX X
                            
X XXXX XX XXX--XXX XX XXXX X
X XXXX XX X      X XX XXXX X
X XXXX XX X      X XX XXXX X
X      XX X      X XX      X
X XXXX XX XXXXXXXX XX XXXX X
X XXXX XX          XX XXXX X
X   XX XX XXXXXXXX XX XX   X
XXX XX XX XXXXXXXX XX XX XXX
XXX XX       XX       XX XXX
    XX XXXXX XX XXXXX XX    
X XXXX XXXXX XX XXXXX XXXX X
X XXXX XX          XX XXXX X
X      XX XX XX XX XX      X
X XX XXXX XX XX XX XXXX XX X
X XX XXXX XX XX XX XXXX XX X
X XX      XX    XX      XX X
X XXXXXXX XXXXXXXX XXXXXXX X
X XXXXXXX XXXXXXXX XXXXXXX X
X                          X
XXXXXXXXXXXXXXXXXXXXXXXXXXXX